########
########
########
########
########
########

+X000+++
+00000@0
@0++0000
0000000@
@000+++@
+++0000-

00000000
00000000
00000000
00000000
00000000
00000*+0