########
########
########
########
########
########

000X0000
0@00000@
++00++00
0@00000@
0++00++@
00@00@-0

00000000
00000000
00000000
*0000000
00000000
+0000000