########
########
########
########
########
########

@0000000
0+++0000
X0000@00
00000@00
0+++0000
@000@00-

000000*0
00000000
00000000
00000000
00*00000
000000+0