########
########
########
########
########
########

@000000@
0@00000@
000+X+00
0@00000@
000@0@00
0000000-

00000000
00000000
00000000
00000000
0000*000
+0000000