########
########
########
########
########
########

@00+000+
X+0000+@
000@00+0
0+0000+0
@00+0@0-
+00000++

00000000
00000000
00000000
00000000
00000000
0+000*00