########
########
########
########
########
########

-0000++0
@+00@00@
0+@0++00
00000000
+000++0+
+@+@00X+

0000000+
00000000
*0000000
00000000
00000000
00000000