########
########
########
########
########
########

+00X00++
00000000
0@@@0000
+000000+
0000@@@0
000-0000

00000000
00000000
00000000
000*0000
00000000
0000+000