########
########
########
########
########
########

000-0000
0@0@00@0
0+0X00+0
0@0000@0
0@@+@@@0
00000000

00000000
000+0000
0000*000
00000000
00000000
00000000