########
########
########
########
########
########

000+0000
0@00@0@-
00@0000+
+00X0@00
0@0000@0
00000+00

+0000000
00000*00
00000000
00000000
00000000
00000000