########
########
########
########
########
########

@0000000
0+00000@
0+00X000
@+0@0000
0000+++@
-000@000

00000000
*0000000
00000000
00000000
00000000
0000000+