########
########
########
########
########
########

00+X0@+0
+000+000
@000000+
+000+@0@
0+0@000+
+00-+00@

0000000+
00000000
00000000
000*0000
00000000
00000000