########
########
########
########
########
########

000@000X
0+000000
@0000000
0000@000
00+000+@
-0000000

+0000000
00000000
00000000
00000000
00000000
000000*0