########
########
########
########
########
########

@000@000
00++++0@
00000000
@000@+00
00000+00
X0@00+0-

000000*0
00000000
00000000
00000000
00000000
000000+0