########
########
########
########
########
########

0000-000
+000000+
+0+00+0+
0@@00@@0
+0+X0+0+
0@0000@0

00+00000
0000*000
00000000
00000000
00000000
00000000