########
########
########
########
########
########

0@000000
0++000+0
0+0X000@
000@00+@
0+000++0
000@000-

000000++
00000000
00000000
00000000
0000*000
00000000