########
########
########
########
########
########

0X000@0@
0@00@00-
00@0@00@
@0000000
@0000@00
0000000@

00000000
00000000
00000000
0000000+
*000000*
+0000000