########
########
########
########
########
########

0000000@
@0+00000
-0+X0+@0
00+00+00
@000@+00
00000000

00000000
00000000
00000000
000000+0
00000000
*0000000