########
########
########
########
########
########

0+0-00@0
@0000000
0+000+@0
00000000
0+@0@+00
00@X@000

00*00000
00000000
0000000+
00000000
00000000
00000000